{
    "0" : [[1,1,1,1,1,1,1,1,1],
        [1,1,1,1,1,1,1,1,1],
        [1,1,1,1,1,1,1,1,1],
        [1,1,1,1,1,1,1,1,1],
        [1,1,1,1,1,1,1,1,1],
        [1,1,1,1,1,1,1,1,1],
        [1,1,1,1,1,1,1,1,1],
        [1,1,1,1,1,3,5,5,1],
        [1,1,1,1,3,3,3,5,5]],

    "1" : [[0,0,0,0,0,0,0,0,0],
        [0,0,0,0,0,0,0,0,0],
        [0,0,0,0,0,0,0,0,0],
        [0,0,0,7,8,9,0,0,0],
        [0,12,0,7,13,9,0,0,0],
        [0,0,0,7,8,9,0,0,0],
        [0,0,0,0,0,0,0,0,0],
        [0,0,0,0,0,0,0,0,0],
        [0,0,0,0,0,0,0,0,0]]
}