{
    "land" : [[1,1,1,1,1,1,1,1,1],
        [1,1,1,1,1,1,1,1,1],
        [1,1,1,1,1,1,1,1,1],
        [1,1,1,1,1,1,1,1,1],
        [1,1,1,1,1,1,1,1,1],
        [1,1,1,1,1,1,1,1,1],
        [1,1,1,1,1,1,1,1,1],
        [1,1,1,1,1,1,1,4,1],
        [1,1,1,1,1,1,1,1,1]],

    "building" : [[0,0,0,0,0,0,0,0,0],
        [0,0,0,0,0,0,0,0,0],
        [0,0,7,0,6,0,0,0,0],
        [0,0,0,0,0,0,0,0,0],
        [0,0,0,0,1,0,0,0,0],
        [0,0,0,0,0,0,0,0,0],
        [0,0,0,0,0,0,0,0,0],
        [0,0,0,0,0,0,0,0,0],
        [0,0,0,0,0,0,0,0,0]],

    "timer" : [[0,0,0,0,0,0,0,0,0],
        [0,0,0,0,0,0,0,0,0],
        [0,0,0,0,0,0,0,0,0],
        [0,0,0,0,0,0,0,0,0],
        [0,0,0,0,0,0,0,0,0],
        [0,0,0,0,0,0,0,0,0],
        [0,0,0,0,0,0,0,0,0],
        [0,0,0,0,0,0,0,0,0],
        [0,0,0,0,0,0,0,0,0]]
}