{
    "land" : [[1,1,1,1,1,1,1,1,1],
        [1,1,1,1,1,1,1,1,1],
        [1,1,1,1,1,1,1,1,1],
        [1,1,1,1,1,1,1,1,1],
        [1,1,1,1,1,1,1,1,1],
        [1,1,1,1,1,1,1,1,1],
        [1,1,1,1,1,1,1,1,1],
        [1,1,1,1,1,1,4,4,1],
        [1,1,1,1,1,1,1,4,4]],

    "building" : [[0,0,0,0,0,0,0,0,0],
        [0,0,0,0,0,0,0,0,0],
        [0,0,0,0,0,0,0,0,0],
        [0,0,0,0,0,0,0,0,0],
        [0,0,0,0,0,0,0,0,0],
        [0,0,0,0,0,0,0,0,0],
        [0,0,0,0,0,0,0,0,0],
        [0,0,0,0,0,0,0,0,0],
        [0,0,0,0,0,0,0,0,0]],

    "timer" : [[0,0,0,0,0,0,0,0,0],
        [0,0,0,0,0,0,0,0,0],
        [0,0,0,0,0,0,0,0,0],
        [0,0,0,0,0,0,0,0,0],
        [0,0,0,0,0,0,0,0,0],
        [0,0,0,0,0,0,0,0,0],
        [0,0,0,0,0,0,0,0,0],
        [0,0,0,0,0,0,0,0,0],
        [0,0,0,0,0,0,0,0,0]]
}