{
    "0" : [[1,1,1,1,1,1,1,1,1],
        [1,1,1,1,1,1,1,1,1],
        [1,1,1,1,1,1,1,1,1],
        [1,1,1,1,1,1,1,1,1],
        [1,1,1,1,1,1,1,1,1],
        [1,1,1,1,1,1,1,1,1],
        [1,1,1,1,1,1,1,1,1],
        [1,1,1,1,1,3,5,5,1],
        [1,1,1,1,3,3,3,5,5]],

    "1" : [[12,0,0,0,0,0,0,0,0],
        [0,0,0,0,0,0,0,0,0],
        [0,0,0,0,0,0,0,0,0],
        [0,0,0,10,10,10,0,0,0],
        [0,0,0,10,13,10,0,0,0],
        [0,0,0,10,10,10,10,0,0],
        [0,0,0,0,0,0,0,0,0],
        [0,0,0,0,0,0,0,0,0],
        [0,0,0,0,0,0,0,0,12]]
}